Month,Mrtg Payment,Interest,Principal,PMI-Range,Property Tax Avg,House Insur Avg,Utilities,Car Insurance,Misc Bill,Internet,Totals,Loan Balance,Total Principal Payed,Total Interest,Month Total,Minimum Income 28% model
1,1390,1191,199,$0 - $0,292.5,108.92,300,30,30,30,,219801,199,1191,2181.42,76230.5
2,1390,1190,200,$0 - $0,292.5,108.92,300,30,30,30,,219601,399,2381,2181.42,76230.5
3,1390,1189,201,$0 - $0,292.5,108.92,300,30,30,30,,219400,600,3570,2181.42,76230.5
4,1390,1188,202,$0 - $0,292.5,108.92,300,30,30,30,,219198,802,4758,2181.42,76230.5
5,1390,1187,203,$0 - $0,292.5,108.92,300,30,30,30,,218995,1005,5945,2181.42,76230.5
6,1390,1186,204,$0 - $0,292.5,108.92,300,30,30,30,,218791,1209,7131,2181.42,76230.5
7,1390,1185,205,$0 - $0,292.5,108.92,300,30,30,30,,218586,1414,8316,2181.42,76230.5
8,1390,1184,206,$0 - $0,292.5,108.92,300,30,30,30,,218380,1620,9500,2181.42,76230.5
9,1390,1182,208,$0 - $0,292.5,108.92,300,30,30,30,,218172,1828,10682,2181.42,76230.5
10,1390,1181,209,$0 - $0,292.5,108.92,300,30,30,30,,217963,2037,11863,2181.42,76230.5
11,1390,1180,210,$0 - $0,292.5,108.92,300,30,30,30,,217753,2247,13043,2181.42,76230.5
12,1390,1179,211,$0 - $0,292.5,108.92,300,30,30,30,,217542,2458,14222,2181.42,76230.5
13,1390,1178,212,$0 - $0,292.5,108.92,300,30,30,30,,217330,2670,15400,2181.42,76230.5
14,1390,1177,213,$0 - $0,292.5,108.92,300,30,30,30,,217117,2883,16577,2181.42,76230.5
15,1390,1176,214,$0 - $0,292.5,108.92,300,30,30,30,,216903,3097,17753,2181.42,76230.5
16,1390,1174,216,$0 - $0,292.5,108.92,300,30,30,30,,216687,3313,18927,2181.42,76230.5
17,1390,1173,217,$0 - $0,292.5,108.92,300,30,30,30,,216470,3530,20100,2181.42,76230.5
18,1390,1172,218,$0 - $0,292.5,108.92,300,30,30,30,,216252,3748,21272,2181.42,76230.5
19,1390,1171,219,$0 - $0,292.5,108.92,300,30,30,30,,216033,3967,22443,2181.42,76230.5
20,1390,1170,220,$0 - $0,292.5,108.92,300,30,30,30,,215813,4187,23613,2181.42,76230.5
21,1390,1168,222,$0 - $0,292.5,108.92,300,30,30,30,,215591,4409,24781,2181.42,76230.5
22,1390,1167,223,$0 - $0,292.5,108.92,300,30,30,30,,215368,4632,25948,2181.42,76230.5
23,1390,1166,224,$0 - $0,292.5,108.92,300,30,30,30,,215144,4856,27114,2181.42,76230.5
24,1390,1165,225,$0 - $0,292.5,108.92,300,30,30,30,,214919,5081,28279,2181.42,76230.5
25,1390,1164,226,$0 - $0,292.5,108.92,300,30,30,30,,214693,5307,29443,2181.42,76230.5
26,1390,1162,228,$0 - $0,292.5,108.92,300,30,30,30,,214465,5535,30605,2181.42,76230.5
27,1390,1161,229,$0 - $0,292.5,108.92,300,30,30,30,,214236,5764,31766,2181.42,76230.5
28,1390,1160,230,$0 - $0,292.5,108.92,300,30,30,30,,214006,5994,32926,2181.42,76230.5
29,1390,1159,231,$0 - $0,292.5,108.92,300,30,30,30,,213775,6225,34085,2181.42,76230.5
30,1390,1157,233,$0 - $0,292.5,108.92,300,30,30,30,,213542,6458,35242,2181.42,76230.5
31,1390,1156,234,$0 - $0,292.5,108.92,300,30,30,30,,213308,6692,36398,2181.42,76230.5
32,1390,1155,235,$0 - $0,292.5,108.92,300,30,30,30,,213073,6927,37553,2181.42,76230.5
33,1390,1154,236,$0 - $0,292.5,108.92,300,30,30,30,,212837,7163,38707,2181.42,76230.5
34,1390,1152,238,$0 - $0,292.5,108.92,300,30,30,30,,212599,7401,39859,2181.42,76230.5
35,1390,1151,239,$0 - $0,292.5,108.92,300,30,30,30,,212360,7640,41010,2181.42,76230.5
36,1390,1150,240,$0 - $0,292.5,108.92,300,30,30,30,,212120,7880,42160,2181.42,76230.5
37,1390,1148,242,$0 - $0,292.5,108.92,300,30,30,30,,211878,8122,43308,2181.42,76230.5
38,1390,1147,243,$0 - $0,292.5,108.92,300,30,30,30,,211635,8365,44455,2181.42,76230.5
39,1390,1146,244,$0 - $0,292.5,108.92,300,30,30,30,,211391,8609,45601,2181.42,76230.5
40,1390,1145,245,$0 - $0,292.5,108.92,300,30,30,30,,211146,8854,46746,2181.42,76230.5
41,1390,1143,247,$0 - $0,292.5,108.92,300,30,30,30,,210899,9101,47889,2181.42,76230.5
42,1390,1142,248,$0 - $0,292.5,108.92,300,30,30,30,,210651,9349,49031,2181.42,76230.5
43,1390,1141,249,$0 - $0,292.5,108.92,300,30,30,30,,210402,9598,50172,2181.42,76230.5
44,1390,1139,251,$0 - $0,292.5,108.92,300,30,30,30,,210151,9849,51311,2181.42,76230.5
45,1390,1138,252,$0 - $0,292.5,108.92,300,30,30,30,,209899,10101,52449,2181.42,76230.5
46,1390,1136,254,$0 - $0,292.5,108.92,300,30,30,30,,209645,10355,53585,2181.42,76230.5
47,1390,1135,255,$0 - $0,292.5,108.92,300,30,30,30,,209390,10610,54720,2181.42,76230.5
48,1390,1134,256,$0 - $0,292.5,108.92,300,30,30,30,,209134,10866,55854,2181.42,76230.5
49,1390,1132,258,$0 - $0,292.5,108.92,300,30,30,30,,208876,11124,56986,2181.42,76230.5
50,1390,1131,259,$0 - $0,292.5,108.92,300,30,30,30,,208617,11383,58117,2181.42,76230.5
51,1390,1130,260,$0 - $0,292.5,108.92,300,30,30,30,,208357,11643,59247,2181.42,76230.5
52,1390,1128,262,$0 - $0,292.5,108.92,300,30,30,30,,208095,11905,60375,2181.42,76230.5
53,1390,1127,263,$0 - $0,292.5,108.92,300,30,30,30,,207832,12168,61502,2181.42,76230.5
54,1390,1125,265,$0 - $0,292.5,108.92,300,30,30,30,,207567,12433,62627,2181.42,76230.5
55,1390,1124,266,$0 - $0,292.5,108.92,300,30,30,30,,207301,12699,63751,2181.42,76230.5
56,1390,1122,268,$0 - $0,292.5,108.92,300,30,30,30,,207033,12967,64873,2181.42,76230.5
57,1390,1121,269,$0 - $0,292.5,108.92,300,30,30,30,,206764,13236,65994,2181.42,76230.5
58,1390,1119,271,$0 - $0,292.5,108.92,300,30,30,30,,206493,13507,67113,2181.42,76230.5
59,1390,1118,272,$0 - $0,292.5,108.92,300,30,30,30,,206221,13779,68231,2181.42,76230.5
60,1390,1117,273,$0 - $0,292.5,108.92,300,30,30,30,,205948,14052,69348,2181.42,76230.5
61,1390,1115,275,$0 - $0,292.5,108.92,300,30,30,30,,205673,14327,70463,2181.42,76230.5
62,1390,1114,276,$0 - $0,292.5,108.92,300,30,30,30,,205397,14603,71577,2181.42,76230.5
63,1390,1112,278,$0 - $0,292.5,108.92,300,30,30,30,,205119,14881,72689,2181.42,76230.5
64,1390,1111,279,$0 - $0,292.5,108.92,300,30,30,30,,204840,15160,73800,2181.42,76230.5
65,1390,1109,281,$0 - $0,292.5,108.92,300,30,30,30,,204559,15441,74909,2181.42,76230.5
66,1390,1108,282,$0 - $0,292.5,108.92,300,30,30,30,,204277,15723,76017,2181.42,76230.5
67,1390,1106,284,$0 - $0,292.5,108.92,300,30,30,30,,203993,16007,77123,2181.42,76230.5
68,1390,1104,286,$0 - $0,292.5,108.92,300,30,30,30,,203707,16293,78227,2181.42,76230.5
69,1390,1103,287,$0 - $0,292.5,108.92,300,30,30,30,,203420,16580,79330,2181.42,76230.5
70,1390,1101,289,$0 - $0,292.5,108.92,300,30,30,30,,203131,16869,80431,2181.42,76230.5
71,1390,1100,290,$0 - $0,292.5,108.92,300,30,30,30,,202841,17159,81531,2181.42,76230.5
72,1390,1098,292,$0 - $0,292.5,108.92,300,30,30,30,,202549,17451,82629,2181.42,76230.5
73,1390,1097,293,$0 - $0,292.5,108.92,300,30,30,30,,202256,17744,83726,2181.42,76230.5
74,1390,1095,295,$0 - $0,292.5,108.92,300,30,30,30,,201961,18039,84821,2181.42,76230.5
75,1390,1093,297,$0 - $0,292.5,108.92,300,30,30,30,,201664,18336,85914,2181.42,76230.5
76,1390,1092,298,$0 - $0,292.5,108.92,300,30,30,30,,201366,18634,87006,2181.42,76230.5
77,1390,1090,300,$0 - $0,292.5,108.92,300,30,30,30,,201066,18934,88096,2181.42,76230.5
78,1390,1089,301,$0 - $0,292.5,108.92,300,30,30,30,,200765,19235,89185,2181.42,76230.5
79,1390,1087,303,$0 - $0,292.5,108.92,300,30,30,30,,200462,19538,90272,2181.42,76230.5
80,1390,1085,305,$0 - $0,292.5,108.92,300,30,30,30,,200157,19843,91357,2181.42,76230.5
81,1390,1084,306,$0 - $0,292.5,108.92,300,30,30,30,,199851,20149,92441,2181.42,76230.5
82,1390,1082,308,$0 - $0,292.5,108.92,300,30,30,30,,199543,20457,93523,2181.42,76230.5
83,1390,1080,310,$0 - $0,292.5,108.92,300,30,30,30,,199233,20767,94603,2181.42,76230.5
84,1390,1079,311,$0 - $0,292.5,108.92,300,30,30,30,,198922,21078,95682,2181.42,76230.5
85,1390,1077,313,$0 - $0,292.5,108.92,300,30,30,30,,198609,21391,96759,2181.42,76230.5
86,1390,1075,315,$0 - $0,292.5,108.92,300,30,30,30,,198294,21706,97834,2181.42,76230.5
87,1390,1074,316,$0 - $0,292.5,108.92,300,30,30,30,,197978,22022,98908,2181.42,76230.5
88,1390,1072,318,$0 - $0,292.5,108.92,300,30,30,30,,197660,22340,99980,2181.42,76230.5
89,1390,1070,320,$0 - $0,292.5,108.92,300,30,30,30,,197340,22660,101050,2181.42,76230.5
90,1390,1068,322,$0 - $0,292.5,108.92,300,30,30,30,,197018,22982,102118,2181.42,76230.5
91,1390,1067,323,$0 - $0,292.5,108.92,300,30,30,30,,196695,23305,103185,2181.42,76230.5
92,1390,1065,325,$0 - $0,292.5,108.92,300,30,30,30,,196370,23630,104250,2181.42,76230.5
93,1390,1063,327,$0 - $0,292.5,108.92,300,30,30,30,,196043,23957,105313,2181.42,76230.5
94,1390,1061,329,$0 - $0,292.5,108.92,300,30,30,30,,195714,24286,106374,2181.42,76230.5
95,1390,1060,330,$0 - $0,292.5,108.92,300,30,30,30,,195384,24616,107434,2181.42,76230.5
96,1390,1058,332,$0 - $0,292.5,108.92,300,30,30,30,,195052,24948,108492,2181.42,76230.5
97,1390,1056,334,$0 - $0,292.5,108.92,300,30,30,30,,194718,25282,109548,2181.42,76230.5
98,1390,1054,336,$0 - $0,292.5,108.92,300,30,30,30,,194382,25618,110602,2181.42,76230.5
99,1390,1052,338,$0 - $0,292.5,108.92,300,30,30,30,,194044,25956,111654,2181.42,76230.5
100,1390,1051,339,$0 - $0,292.5,108.92,300,30,30,30,,193705,26295,112705,2181.42,76230.5
101,1390,1049,341,$0 - $0,292.5,108.92,300,30,30,30,,193364,26636,113754,2181.42,76230.5
102,1390,1047,343,$0 - $0,292.5,108.92,300,30,30,30,,193021,26979,114801,2181.42,76230.5
103,1390,1045,345,$0 - $0,292.5,108.92,300,30,30,30,,192676,27324,115846,2181.42,76230.5
104,1390,1043,347,$0 - $0,292.5,108.92,300,30,30,30,,192329,27671,116889,2181.42,76230.5
105,1390,1041,349,$0 - $0,292.5,108.92,300,30,30,30,,191980,28020,117930,2181.42,76230.5
106,1390,1039,351,$0 - $0,292.5,108.92,300,30,30,30,,191629,28371,118969,2181.42,76230.5
107,1390,1037,353,$0 - $0,292.5,108.92,300,30,30,30,,191276,28724,120006,2181.42,76230.5
108,1390,1036,354,$0 - $0,292.5,108.92,300,30,30,30,,190922,29078,121042,2181.42,76230.5
109,1390,1034,356,$0 - $0,292.5,108.92,300,30,30,30,,190566,29434,122076,2181.42,76230.5
110,1390,1032,358,$0 - $0,292.5,108.92,300,30,30,30,,190208,29792,123108,2181.42,76230.5
111,1390,1030,360,$0 - $0,292.5,108.92,300,30,30,30,,189848,30152,124138,2181.42,76230.5
112,1390,1028,362,$0 - $0,292.5,108.92,300,30,30,30,,189486,30514,125166,2181.42,76230.5
113,1390,1026,364,$0 - $0,292.5,108.92,300,30,30,30,,189122,30878,126192,2181.42,76230.5
114,1390,1024,366,$0 - $0,292.5,108.92,300,30,30,30,,188756,31244,127216,2181.42,76230.5
115,1390,1022,368,$0 - $0,292.5,108.92,300,30,30,30,,188388,31612,128238,2181.42,76230.5
116,1390,1020,370,$0 - $0,292.5,108.92,300,30,30,30,,188018,31982,129258,2181.42,76230.5
117,1390,1018,372,$0 - $0,292.5,108.92,300,30,30,30,,187646,32354,130276,2181.42,76230.5
118,1390,1016,374,$0 - $0,292.5,108.92,300,30,30,30,,187272,32728,131292,2181.42,76230.5
119,1390,1014,376,$0 - $0,292.5,108.92,300,30,30,30,,186896,33104,132306,2181.42,76230.5
120,1390,1012,378,$0 - $0,292.5,108.92,300,30,30,30,,186518,33482,133318,2181.42,76230.5
121,1390,1010,380,$0 - $0,292.5,108.92,300,30,30,30,,186138,33862,134328,2181.42,76230.5
122,1390,1008,382,$0 - $0,292.5,108.92,300,30,30,30,,185756,34244,135336,2181.42,76230.5
123,1390,1006,384,$0 - $0,292.5,108.92,300,30,30,30,,185372,34628,136342,2181.42,76230.5
124,1390,1004,386,$0 - $0,292.5,108.92,300,30,30,30,,184986,35014,137346,2181.42,76230.5
125,1390,1002,388,$0 - $0,292.5,108.92,300,30,30,30,,184598,35402,138348,2181.42,76230.5
126,1390,999,391,$0 - $0,292.5,108.92,300,30,30,30,,184207,35793,139347,2181.42,76230.5
127,1390,997,393,$0 - $0,292.5,108.92,300,30,30,30,,183814,36186,140344,2181.42,76230.5
128,1390,995,395,$0 - $0,292.5,108.92,300,30,30,30,,183419,36581,141339,2181.42,76230.5
129,1390,993,397,$0 - $0,292.5,108.92,300,30,30,30,,183022,36978,142332,2181.42,76230.5
130,1390,991,399,$0 - $0,292.5,108.92,300,30,30,30,,182623,37377,143323,2181.42,76230.5
131,1390,989,401,$0 - $0,292.5,108.92,300,30,30,30,,182222,37778,144312,2181.42,76230.5
132,1390,987,403,$0 - $0,292.5,108.92,300,30,30,30,,181819,38181,145299,2181.42,76230.5
133,1390,984,406,$0 - $0,292.5,108.92,300,30,30,30,,181413,38587,146283,2181.42,76230.5
134,1390,982,408,$0 - $0,292.5,108.92,300,30,30,30,,181005,38995,147265,2181.42,76230.5
135,1390,980,410,$0 - $0,292.5,108.92,300,30,30,30,,180595,39405,148245,2181.42,76230.5
136,1390,978,412,$0 - $0,292.5,108.92,300,30,30,30,,180183,39817,149223,2181.42,76230.5
137,1390,975,415,$0 - $0,292.5,108.92,300,30,30,30,,179768,40232,150198,2181.42,76230.5
138,1390,973,417,$0 - $0,292.5,108.92,300,30,30,30,,179351,40649,151171,2181.42,76230.5
139,1390,971,419,$0 - $0,292.5,108.92,300,30,30,30,,178932,41068,152142,2181.42,76230.5
140,1390,969,421,$0 - $0,292.5,108.92,300,30,30,30,,178511,41489,153111,2181.42,76230.5
141,1390,966,424,$0 - $0,292.5,108.92,300,30,30,30,,178087,41913,154077,2181.42,76230.5
142,1390,964,426,$0 - $0,292.5,108.92,300,30,30,30,,177661,42339,155041,2181.42,76230.5
143,1390,962,428,$0 - $0,292.5,108.92,300,30,30,30,,177233,42767,156003,2181.42,76230.5
144,1390,960,430,$0 - $0,292.5,108.92,300,30,30,30,,176803,43197,156963,2181.42,76230.5
145,1390,957,433,$0 - $0,292.5,108.92,300,30,30,30,,176370,43630,157920,2181.42,76230.5
146,1390,955,435,$0 - $0,292.5,108.92,300,30,30,30,,175935,44065,158875,2181.42,76230.5
147,1390,952,438,$0 - $0,292.5,108.92,300,30,30,30,,175497,44503,159827,2181.42,76230.5
148,1390,950,440,$0 - $0,292.5,108.92,300,30,30,30,,175057,44943,160777,2181.42,76230.5
149,1390,948,442,$0 - $0,292.5,108.92,300,30,30,30,,174615,45385,161725,2181.42,76230.5
150,1390,945,445,$0 - $0,292.5,108.92,300,30,30,30,,174170,45830,162670,2181.42,76230.5
151,1390,943,447,$0 - $0,292.5,108.92,300,30,30,30,,173723,46277,163613,2181.42,76230.5
152,1390,940,450,$0 - $0,292.5,108.92,300,30,30,30,,173273,46727,164553,2181.42,76230.5
153,1390,938,452,$0 - $0,292.5,108.92,300,30,30,30,,172821,47179,165491,2181.42,76230.5
154,1390,936,454,$0 - $0,292.5,108.92,300,30,30,30,,172367,47633,166427,2181.42,76230.5
155,1390,933,457,$0 - $0,292.5,108.92,300,30,30,30,,171910,48090,167360,2181.42,76230.5
156,1390,931,459,$0 - $0,292.5,108.92,300,30,30,30,,171451,48549,168291,2181.42,76230.5
157,1390,928,462,$0 - $0,292.5,108.92,300,30,30,30,,170989,49011,169219,2181.42,76230.5
158,1390,926,464,$0 - $0,292.5,108.92,300,30,30,30,,170525,49475,170145,2181.42,76230.5
159,1390,923,467,$0 - $0,292.5,108.92,300,30,30,30,,170058,49942,171068,2181.42,76230.5
160,1390,921,469,$0 - $0,292.5,108.92,300,30,30,30,,169589,50411,171989,2181.42,76230.5
161,1390,918,472,$0 - $0,292.5,108.92,300,30,30,30,,169117,50883,172907,2181.42,76230.5
162,1390,916,474,$0 - $0,292.5,108.92,300,30,30,30,,168643,51357,173823,2181.42,76230.5
163,1390,913,477,$0 - $0,292.5,108.92,300,30,30,30,,168166,51834,174736,2181.42,76230.5
164,1390,910,480,$0 - $0,292.5,108.92,300,30,30,30,,167686,52314,175646,2181.42,76230.5
165,1390,908,482,$0 - $0,292.5,108.92,300,30,30,30,,167204,52796,176554,2181.42,76230.5
166,1390,905,485,$0 - $0,292.5,108.92,300,30,30,30,,166719,53281,177459,2181.42,76230.5
167,1390,903,487,$0 - $0,292.5,108.92,300,30,30,30,,166232,53768,178362,2181.42,76230.5
168,1390,900,490,$0 - $0,292.5,108.92,300,30,30,30,,165742,54258,179262,2181.42,76230.5
169,1390,897,493,$0 - $0,292.5,108.92,300,30,30,30,,165249,54751,180159,2181.42,76230.5
170,1390,895,495,$0 - $0,292.5,108.92,300,30,30,30,,164754,55246,181054,2181.42,76230.5
171,1390,892,498,$0 - $0,292.5,108.92,300,30,30,30,,164256,55744,181946,2181.42,76230.5
172,1390,889,501,$0 - $0,292.5,108.92,300,30,30,30,,163755,56245,182835,2181.42,76230.5
173,1390,887,503,$0 - $0,292.5,108.92,300,30,30,30,,163252,56748,183722,2181.42,76230.5
174,1390,884,506,$0 - $0,292.5,108.92,300,30,30,30,,162746,57254,184606,2181.42,76230.5
175,1390,881,509,$0 - $0,292.5,108.92,300,30,30,30,,162237,57763,185487,2181.42,76230.5
176,1390,878,512,$0 - $0,292.5,108.92,300,30,30,30,,161725,58275,186365,2181.42,76230.5
177,1390,876,514,$0 - $0,292.5,108.92,300,30,30,30,,161211,58789,187241,2181.42,76230.5
178,1390,873,517,$0 - $0,292.5,108.92,300,30,30,30,,160694,59306,188114,2181.42,76230.5
179,1390,870,520,$0 - $0,292.5,108.92,300,30,30,30,,160174,59826,188984,2181.42,76230.5
180,1390,867,523,$0 - $0,292.5,108.92,300,30,30,30,,159651,60349,189851,2181.42,76230.5
181,1390,864,526,$0 - $0,292.5,108.92,300,30,30,30,,159125,60875,190715,2181.42,76230.5
182,1390,861,529,$0 - $0,292.5,108.92,300,30,30,30,,158596,61404,191576,2181.42,76230.5
183,1390,859,531,$0 - $0,292.5,108.92,300,30,30,30,,158065,61935,192435,2181.42,76230.5
184,1390,856,534,$0 - $0,292.5,108.92,300,30,30,30,,157531,62469,193291,2181.42,76230.5
185,1390,853,537,$0 - $0,292.5,108.92,300,30,30,30,,156994,63006,194144,2181.42,76230.5
186,1390,850,540,$0 - $0,292.5,108.92,300,30,30,30,,156454,63546,194994,2181.42,76230.5
187,1390,847,543,$0 - $0,292.5,108.92,300,30,30,30,,155911,64089,195841,2181.42,76230.5
188,1390,844,546,$0 - $0,292.5,108.92,300,30,30,30,,155365,64635,196685,2181.42,76230.5
189,1390,841,549,$0 - $0,292.5,108.92,300,30,30,30,,154816,65184,197526,2181.42,76230.5
190,1390,838,552,$0 - $0,292.5,108.92,300,30,30,30,,154264,65736,198364,2181.42,76230.5
191,1390,835,555,$0 - $0,292.5,108.92,300,30,30,30,,153709,66291,199199,2181.42,76230.5
192,1390,832,558,$0 - $0,292.5,108.92,300,30,30,30,,153151,66849,200031,2181.42,76230.5
193,1390,829,561,$0 - $0,292.5,108.92,300,30,30,30,,152590,67410,200860,2181.42,76230.5
194,1390,826,564,$0 - $0,292.5,108.92,300,30,30,30,,152026,67974,201686,2181.42,76230.5
195,1390,823,567,$0 - $0,292.5,108.92,300,30,30,30,,151459,68541,202509,2181.42,76230.5
196,1390,820,570,$0 - $0,292.5,108.92,300,30,30,30,,150889,69111,203329,2181.42,76230.5
197,1390,817,573,$0 - $0,292.5,108.92,300,30,30,30,,150316,69684,204146,2181.42,76230.5
198,1390,814,576,$0 - $0,292.5,108.92,300,30,30,30,,149740,70260,204960,2181.42,76230.5
199,1390,811,579,$0 - $0,292.5,108.92,300,30,30,30,,149161,70839,205771,2181.42,76230.5
200,1390,807,583,$0 - $0,292.5,108.92,300,30,30,30,,148578,71422,206578,2181.42,76230.5
201,1390,804,586,$0 - $0,292.5,108.92,300,30,30,30,,147992,72008,207382,2181.42,76230.5
202,1390,801,589,$0 - $0,292.5,108.92,300,30,30,30,,147403,72597,208183,2181.42,76230.5
203,1390,798,592,$0 - $0,292.5,108.92,300,30,30,30,,146811,73189,208981,2181.42,76230.5
204,1390,795,595,$0 - $0,292.5,108.92,300,30,30,30,,146216,73784,209776,2181.42,76230.5
205,1390,792,598,$0 - $0,292.5,108.92,300,30,30,30,,145618,74382,210568,2181.42,76230.5
206,1390,788,602,$0 - $0,292.5,108.92,300,30,30,30,,145016,74984,211356,2181.42,76230.5
207,1390,785,605,$0 - $0,292.5,108.92,300,30,30,30,,144411,75589,212141,2181.42,76230.5
208,1390,782,608,$0 - $0,292.5,108.92,300,30,30,30,,143803,76197,212923,2181.42,76230.5
209,1390,778,612,$0 - $0,292.5,108.92,300,30,30,30,,143191,76809,213701,2181.42,76230.5
210,1390,775,615,$0 - $0,292.5,108.92,300,30,30,30,,142576,77424,214476,2181.42,76230.5
211,1390,772,618,$0 - $0,292.5,108.92,300,30,30,30,,141958,78042,215248,2181.42,76230.5
212,1390,768,622,$0 - $0,292.5,108.92,300,30,30,30,,141336,78664,216016,2181.42,76230.5
213,1390,765,625,$0 - $0,292.5,108.92,300,30,30,30,,140711,79289,216781,2181.42,76230.5
214,1390,762,628,$0 - $0,292.5,108.92,300,30,30,30,,140083,79917,217543,2181.42,76230.5
215,1390,758,632,$0 - $0,292.5,108.92,300,30,30,30,,139451,80549,218301,2181.42,76230.5
216,1390,755,635,$0 - $0,292.5,108.92,300,30,30,30,,138816,81184,219056,2181.42,76230.5
217,1390,751,639,$0 - $0,292.5,108.92,300,30,30,30,,138177,81823,219807,2181.42,76230.5
218,1390,748,642,$0 - $0,292.5,108.92,300,30,30,30,,137535,82465,220555,2181.42,76230.5
219,1390,744,646,$0 - $0,292.5,108.92,300,30,30,30,,136889,83111,221299,2181.42,76230.5
220,1390,741,649,$0 - $0,292.5,108.92,300,30,30,30,,136240,83760,222040,2181.42,76230.5
221,1390,737,653,$0 - $0,292.5,108.92,300,30,30,30,,135587,84413,222777,2181.42,76230.5
222,1390,734,656,$0 - $0,292.5,108.92,300,30,30,30,,134931,85069,223511,2181.42,76230.5
223,1390,730,660,$0 - $0,292.5,108.92,300,30,30,30,,134271,85729,224241,2181.42,76230.5
224,1390,727,663,$0 - $0,292.5,108.92,300,30,30,30,,133608,86392,224968,2181.42,76230.5
225,1390,723,667,$0 - $0,292.5,108.92,300,30,30,30,,132941,87059,225691,2181.42,76230.5
226,1390,720,670,$0 - $0,292.5,108.92,300,30,30,30,,132271,87729,226411,2181.42,76230.5
227,1390,716,674,$0 - $0,292.5,108.92,300,30,30,30,,131597,88403,227127,2181.42,76230.5
228,1390,712,678,$0 - $0,292.5,108.92,300,30,30,30,,130919,89081,227839,2181.42,76230.5
229,1390,709,681,$0 - $0,292.5,108.92,300,30,30,30,,130238,89762,228548,2181.42,76230.5
230,1390,705,685,$0 - $0,292.5,108.92,300,30,30,30,,129553,90447,229253,2181.42,76230.5
231,1390,701,689,$0 - $0,292.5,108.92,300,30,30,30,,128864,91136,229954,2181.42,76230.5
232,1390,698,692,$0 - $0,292.5,108.92,300,30,30,30,,128172,91828,230652,2181.42,76230.5
233,1390,694,696,$0 - $0,292.5,108.92,300,30,30,30,,127476,92524,231346,2181.42,76230.5
234,1390,690,700,$0 - $0,292.5,108.92,300,30,30,30,,126776,93224,232036,2181.42,76230.5
235,1390,686,704,$0 - $0,292.5,108.92,300,30,30,30,,126072,93928,232722,2181.42,76230.5
236,1390,682,708,$0 - $0,292.5,108.92,300,30,30,30,,125364,94636,233404,2181.42,76230.5
237,1390,679,711,$0 - $0,292.5,108.92,300,30,30,30,,124653,95347,234083,2181.42,76230.5
238,1390,675,715,$0 - $0,292.5,108.92,300,30,30,30,,123938,96062,234758,2181.42,76230.5
239,1390,671,719,$0 - $0,292.5,108.92,300,30,30,30,,123219,96781,235429,2181.42,76230.5
240,1390,667,723,$0 - $0,292.5,108.92,300,30,30,30,,122496,97504,236096,2181.42,76230.5
241,1390,663,727,$0 - $0,292.5,108.92,300,30,30,30,,121769,98231,236759,2181.42,76230.5
242,1390,659,731,$0 - $0,292.5,108.92,300,30,30,30,,121038,98962,237418,2181.42,76230.5
243,1390,655,735,$0 - $0,292.5,108.92,300,30,30,30,,120303,99697,238073,2181.42,76230.5
244,1390,651,739,$0 - $0,292.5,108.92,300,30,30,30,,119564,100436,238724,2181.42,76230.5
245,1390,647,743,$0 - $0,292.5,108.92,300,30,30,30,,118821,101179,239371,2181.42,76230.5
246,1390,643,747,$0 - $0,292.5,108.92,300,30,30,30,,118074,101926,240014,2181.42,76230.5
247,1390,639,751,$0 - $0,292.5,108.92,300,30,30,30,,117323,102677,240653,2181.42,76230.5
248,1390,635,755,$0 - $0,292.5,108.92,300,30,30,30,,116568,103432,241288,2181.42,76230.5
249,1390,631,759,$0 - $0,292.5,108.92,300,30,30,30,,115809,104191,241919,2181.42,76230.5
250,1390,627,763,$0 - $0,292.5,108.92,300,30,30,30,,115046,104954,242546,2181.42,76230.5
251,1390,623,767,$0 - $0,292.5,108.92,300,30,30,30,,114279,105721,243169,2181.42,76230.5
252,1390,619,771,$0 - $0,292.5,108.92,300,30,30,30,,113508,106492,243788,2181.42,76230.5
253,1390,614,776,$0 - $0,292.5,108.92,300,30,30,30,,112732,107268,244402,2181.42,76230.5
254,1390,610,780,$0 - $0,292.5,108.92,300,30,30,30,,111952,108048,245012,2181.42,76230.5
255,1390,606,784,$0 - $0,292.5,108.92,300,30,30,30,,111168,108832,245618,2181.42,76230.5
256,1390,602,788,$0 - $0,292.5,108.92,300,30,30,30,,110380,109620,246220,2181.42,76230.5
257,1390,597,793,$0 - $0,292.5,108.92,300,30,30,30,,109587,110413,246817,2181.42,76230.5
258,1390,593,797,$0 - $0,292.5,108.92,300,30,30,30,,108790,111210,247410,2181.42,76230.5
259,1390,589,801,$0 - $0,292.5,108.92,300,30,30,30,,107989,112011,247999,2181.42,76230.5
260,1390,584,806,$0 - $0,292.5,108.92,300,30,30,30,,107183,112817,248583,2181.42,76230.5
261,1390,580,810,$0 - $0,292.5,108.92,300,30,30,30,,106373,113627,249163,2181.42,76230.5
262,1390,576,814,$0 - $0,292.5,108.92,300,30,30,30,,105559,114441,249739,2181.42,76230.5
263,1390,571,819,$0 - $0,292.5,108.92,300,30,30,30,,104740,115260,250310,2181.42,76230.5
264,1390,567,823,$0 - $0,292.5,108.92,300,30,30,30,,103917,116083,250877,2181.42,76230.5
265,1390,562,828,$0 - $0,292.5,108.92,300,30,30,30,,103089,116911,251439,2181.42,76230.5
266,1390,558,832,$0 - $0,292.5,108.92,300,30,30,30,,102257,117743,251997,2181.42,76230.5
267,1390,553,837,$0 - $0,292.5,108.92,300,30,30,30,,101420,118580,252550,2181.42,76230.5
268,1390,549,841,$0 - $0,292.5,108.92,300,30,30,30,,100579,119421,253099,2181.42,76230.5
269,1390,544,846,$0 - $0,292.5,108.92,300,30,30,30,,99733,120267,253643,2181.42,76230.5
270,1390,540,850,$0 - $0,292.5,108.92,300,30,30,30,,98883,121117,254183,2181.42,76230.5
271,1390,535,855,$0 - $0,292.5,108.92,300,30,30,30,,98028,121972,254718,2181.42,76230.5
272,1390,530,860,$0 - $0,292.5,108.92,300,30,30,30,,97168,122832,255248,2181.42,76230.5
273,1390,526,864,$0 - $0,292.5,108.92,300,30,30,30,,96304,123696,255774,2181.42,76230.5
274,1390,521,869,$0 - $0,292.5,108.92,300,30,30,30,,95435,124565,256295,2181.42,76230.5
275,1390,516,874,$0 - $0,292.5,108.92,300,30,30,30,,94561,125439,256811,2181.42,76230.5
276,1390,512,878,$0 - $0,292.5,108.92,300,30,30,30,,93683,126317,257323,2181.42,76230.5
277,1390,507,883,$0 - $0,292.5,108.92,300,30,30,30,,92800,127200,257830,2181.42,76230.5
278,1390,502,888,$0 - $0,292.5,108.92,300,30,30,30,,91912,128088,258332,2181.42,76230.5
279,1390,497,893,$0 - $0,292.5,108.92,300,30,30,30,,91019,128981,258829,2181.42,76230.5
280,1390,493,897,$0 - $0,292.5,108.92,300,30,30,30,,90122,129878,259322,2181.42,76230.5
281,1390,488,902,$0 - $0,292.5,108.92,300,30,30,30,,89220,130780,259810,2181.42,76230.5
282,1390,483,907,$0 - $0,292.5,108.92,300,30,30,30,,88313,131687,260293,2181.42,76230.5
283,1390,478,912,$0 - $0,292.5,108.92,300,30,30,30,,87401,132599,260771,2181.42,76230.5
284,1390,473,917,$0 - $0,292.5,108.92,300,30,30,30,,86484,133516,261244,2181.42,76230.5
285,1390,468,922,$0 - $0,292.5,108.92,300,30,30,30,,85562,134438,261712,2181.42,76230.5
286,1390,463,927,$0 - $0,292.5,108.92,300,30,30,30,,84635,135365,262175,2181.42,76230.5
287,1390,458,932,$0 - $0,292.5,108.92,300,30,30,30,,83703,136297,262633,2181.42,76230.5
288,1390,453,937,$0 - $0,292.5,108.92,300,30,30,30,,82766,137234,263086,2181.42,76230.5
289,1390,448,942,$0 - $0,292.5,108.92,300,30,30,30,,81824,138176,263534,2181.42,76230.5
290,1390,443,947,$0 - $0,292.5,108.92,300,30,30,30,,80877,139123,263977,2181.42,76230.5
291,1390,438,952,$0 - $0,292.5,108.92,300,30,30,30,,79925,140075,264415,2181.42,76230.5
292,1390,432,958,$0 - $0,292.5,108.92,300,30,30,30,,78967,141033,264847,2181.42,76230.5
293,1390,427,963,$0 - $0,292.5,108.92,300,30,30,30,,78004,141996,265274,2181.42,76230.5
294,1390,422,968,$0 - $0,292.5,108.92,300,30,30,30,,77036,142964,265696,2181.42,76230.5
295,1390,417,973,$0 - $0,292.5,108.92,300,30,30,30,,76063,143937,266113,2181.42,76230.5
296,1390,412,978,$0 - $0,292.5,108.92,300,30,30,30,,75085,144915,266525,2181.42,76230.5
297,1390,406,984,$0 - $0,292.5,108.92,300,30,30,30,,74101,145899,266931,2181.42,76230.5
298,1390,401,989,$0 - $0,292.5,108.92,300,30,30,30,,73112,146888,267332,2181.42,76230.5
299,1390,396,994,$0 - $0,292.5,108.92,300,30,30,30,,72118,147882,267728,2181.42,76230.5
300,1390,390,1000,$0 - $0,292.5,108.92,300,30,30,30,,71118,148882,268118,2181.42,76230.5
301,1390,385,1005,$0 - $0,292.5,108.92,300,30,30,30,,70113,149887,268503,2181.42,76230.5
302,1390,379,1011,$0 - $0,292.5,108.92,300,30,30,30,,69102,150898,268882,2181.42,76230.5
303,1390,374,1016,$0 - $0,292.5,108.92,300,30,30,30,,68086,151914,269256,2181.42,76230.5
304,1390,368,1022,$0 - $0,292.5,108.92,300,30,30,30,,67064,152936,269624,2181.42,76230.5
305,1390,363,1027,$0 - $0,292.5,108.92,300,30,30,30,,66037,153963,269987,2181.42,76230.5
306,1390,357,1033,$0 - $0,292.5,108.92,300,30,30,30,,65004,154996,270344,2181.42,76230.5
307,1390,352,1038,$0 - $0,292.5,108.92,300,30,30,30,,63966,156034,270696,2181.42,76230.5
308,1390,346,1044,$0 - $0,292.5,108.92,300,30,30,30,,62922,157078,271042,2181.42,76230.5
309,1390,340,1050,$0 - $0,292.5,108.92,300,30,30,30,,61872,158128,271382,2181.42,76230.5
310,1390,335,1055,$0 - $0,292.5,108.92,300,30,30,30,,60817,159183,271717,2181.42,76230.5
311,1390,329,1061,$0 - $0,292.5,108.92,300,30,30,30,,59756,160244,272046,2181.42,76230.5
312,1390,323,1067,$0 - $0,292.5,108.92,300,30,30,30,,58689,161311,272369,2181.42,76230.5
313,1390,317,1073,$0 - $0,292.5,108.92,300,30,30,30,,57616,162384,272686,2181.42,76230.5
314,1390,312,1078,$0 - $0,292.5,108.92,300,30,30,30,,56538,163462,272998,2181.42,76230.5
315,1390,306,1084,$0 - $0,292.5,108.92,300,30,30,30,,55454,164546,273304,2181.42,76230.5
316,1390,300,1090,$0 - $0,292.5,108.92,300,30,30,30,,54364,165636,273604,2181.42,76230.5
317,1390,294,1096,$0 - $0,292.5,108.92,300,30,30,30,,53268,166732,273898,2181.42,76230.5
318,1390,288,1102,$0 - $0,292.5,108.92,300,30,30,30,,52166,167834,274186,2181.42,76230.5
319,1390,282,1108,$0 - $0,292.5,108.92,300,30,30,30,,51058,168942,274468,2181.42,76230.5
320,1390,276,1114,$0 - $0,292.5,108.92,300,30,30,30,,49944,170056,274744,2181.42,76230.5
321,1390,270,1120,$0 - $0,292.5,108.92,300,30,30,30,,48824,171176,275014,2181.42,76230.5
322,1390,264,1126,$0 - $0,292.5,108.92,300,30,30,30,,47698,172302,275278,2181.42,76230.5
323,1390,258,1132,$0 - $0,292.5,108.92,300,30,30,30,,46566,173434,275536,2181.42,76230.5
324,1390,252,1138,$0 - $0,292.5,108.92,300,30,30,30,,45428,174572,275788,2181.42,76230.5
325,1390,246,1144,$0 - $0,292.5,108.92,300,30,30,30,,44284,175716,276034,2181.42,76230.5
326,1390,239,1151,$0 - $0,292.5,108.92,300,30,30,30,,43133,176867,276273,2181.42,76230.5
327,1390,233,1157,$0 - $0,292.5,108.92,300,30,30,30,,41976,178024,276506,2181.42,76230.5
328,1390,227,1163,$0 - $0,292.5,108.92,300,30,30,30,,40813,179187,276733,2181.42,76230.5
329,1390,221,1169,$0 - $0,292.5,108.92,300,30,30,30,,39644,180356,276954,2181.42,76230.5
330,1390,214,1176,$0 - $0,292.5,108.92,300,30,30,30,,38468,181532,277168,2181.42,76230.5
331,1390,208,1182,$0 - $0,292.5,108.92,300,30,30,30,,37286,182714,277376,2181.42,76230.5
332,1390,201,1189,$0 - $0,292.5,108.92,300,30,30,30,,36097,183903,277577,2181.42,76230.5
333,1390,195,1195,$0 - $0,292.5,108.92,300,30,30,30,,34902,185098,277772,2181.42,76230.5
334,1390,189,1201,$0 - $0,292.5,108.92,300,30,30,30,,33701,186299,277961,2181.42,76230.5
335,1390,182,1208,$0 - $0,292.5,108.92,300,30,30,30,,32493,187507,278143,2181.42,76230.5
336,1390,176,1214,$0 - $0,292.5,108.92,300,30,30,30,,31279,188721,278319,2181.42,76230.5
337,1390,169,1221,$0 - $0,292.5,108.92,300,30,30,30,,30058,189942,278488,2181.42,76230.5
338,1390,162,1228,$0 - $0,292.5,108.92,300,30,30,30,,28830,191170,278650,2181.42,76230.5
339,1390,156,1234,$0 - $0,292.5,108.92,300,30,30,30,,27596,192404,278806,2181.42,76230.5
340,1390,149,1241,$0 - $0,292.5,108.92,300,30,30,30,,26355,193645,278955,2181.42,76230.5
341,1390,142,1248,$0 - $0,292.5,108.92,300,30,30,30,,25107,194893,279097,2181.42,76230.5
342,1390,135,1255,$0 - $0,292.5,108.92,300,30,30,30,,23852,196148,279232,2181.42,76230.5
343,1390,129,1261,$0 - $0,292.5,108.92,300,30,30,30,,22591,197409,279361,2181.42,76230.5
344,1390,122,1268,$0 - $0,292.5,108.92,300,30,30,30,,21323,198677,279483,2181.42,76230.5
345,1390,115,1275,$0 - $0,292.5,108.92,300,30,30,30,,20048,199952,279598,2181.42,76230.5
346,1390,108,1282,$0 - $0,292.5,108.92,300,30,30,30,,18766,201234,279706,2181.42,76230.5
347,1390,101,1289,$0 - $0,292.5,108.92,300,30,30,30,,17477,202523,279807,2181.42,76230.5
348,1390,94,1296,$0 - $0,292.5,108.92,300,30,30,30,,16181,203819,279901,2181.42,76230.5
349,1390,87,1303,$0 - $0,292.5,108.92,300,30,30,30,,14878,205122,279988,2181.42,76230.5
350,1390,80,1310,$0 - $0,292.5,108.92,300,30,30,30,,13568,206432,280068,2181.42,76230.5
351,1390,73,1317,$0 - $0,292.5,108.92,300,30,30,30,,12251,207749,280141,2181.42,76230.5
352,1390,66,1324,$0 - $0,292.5,108.92,300,30,30,30,,10927,209073,280207,2181.42,76230.5
353,1390,59,1331,$0 - $0,292.5,108.92,300,30,30,30,,9596,210404,280266,2181.42,76230.5
354,1390,51,1339,$0 - $0,292.5,108.92,300,30,30,30,,8257,211743,280317,2181.42,76230.5
355,1390,44,1346,$0 - $0,292.5,108.92,300,30,30,30,,6911,213089,280361,2181.42,76230.5
356,1390,37,1353,$0 - $0,292.5,108.92,300,30,30,30,,5558,214442,280398,2181.42,76230.5
357,1390,30,1360,$0 - $0,292.5,108.92,300,30,30,30,,4198,215802,280428,2181.42,76230.5
358,1390,22,1368,$0 - $0,292.5,108.92,300,30,30,30,,2830,217170,280450,2181.42,76230.5
359,1390,15,1375,$0 - $0,292.5,108.92,300,30,30,30,,1455,218545,280465,2181.42,76230.5
360,1390,7,1383,$0 - $0,292.5,108.92,300,30,30,30,,72,219928,280472,2181.42,76230.5
